{
  "0": "അ",
  "1": "ആ",
  "2": "ഇ",
  "3": "ഈ",
  "4": "ഉ",
  "5": "ഊ",
  "6": "ഋ",
  "7": "എ",
  "8": "ഏ",
  "9": "ഐ",
  "10": "ഒ",
  "11": "ഓ",
  "12": "ഔ",
  "13": "അം",
  "14": "അഃ",
  "15": "ക",
  "16": "ഖ",
  "17": "ഘ",
  "18": "ഗ",
  "19": "ങ",
  "20": "ച",
  "21": "ഛ",
  "22": "ജ",
  "23": "ഝ",
  "24": "ഞ",
  "25": "ട",
  "26": "ഠ",
  "27": "ഡ",
  "28": "ഢ",
  "29": "ണ",
  "30": "ത",
  "31": "ഥ",
  "32": "ദ",
  "33": "ധ",
  "34": "ന",
  "35": "പ",
  "36": "ഫ",
  "37": "ബ",
  "38": "ഭ",
  "39": "മ",
  "40": "യ",
  "41": "ര",
  "42": "ല",
  "43": "വ",
  "44": "ശ",
  "45": "ഷ",
  "46": "സ",
  "47": "ഹ",
  "48": "ള",
  "49": "ഴ",
  "50": "റ"
}